10
-.-.-.-.-.-.-.-.-.-
-.-.-.-.-.-.-.-.-.-
-.-.-.-.G.-.-.-.-.-
-.-.-.-.-.-.-.-.-.-
-.-.-.-.-.-.B.-.-.-
-.-.-.-.B.B.P.B.-.-
-.-.-.B.P.B.B.-.-.-
-.-.-.-.B.-.-.-.-.-
-.-.-.-.A.-.-.-.-.-
-.-.-.-.-.-.-.-.-.-
